七台河=七台河市
万宁=万宁市
三亚=三亚市
三明=三明市
三门峡=三门峡市
上海=上海市
上饶=上饶市
东方=东方市
东莞=东莞市
东营=东营市
中卫=中卫市
中山=中山市
临汾=临汾市
临沂=临沂市
临沧=临沧市
临高=临高县
丹东=丹东市
丽水=丽水市
丽江=丽江市
乌兰察布=乌兰察布市
乌海=乌海市
乌鲁木齐=乌鲁木齐市
乐山=乐山市
九江=九江市
云浮=云浮市
五家渠=五家渠市
五指山=五指山市
亳州=亳州市
仙桃=仙桃市
伊春=伊春市
佛山=佛山市
佳木斯=佳木斯市
保定=保定市
保山=保山市
信阳=信阳市
儋州=儋州市
克拉玛依=克拉玛依市
六安=六安市
六盘水=六盘水市
兰州=兰州市
内江=内江市
包头=包头市
北京=北京市
北海=北海市
十堰=十堰市
南京=南京市
南充=南充市
南宁=南宁市
南平=南平市
南昌=南昌市
南通=南通市
南阳=南阳市
厦门=厦门市
双鸭山=双鸭山市
台州=台州市
合肥=合肥市
吉安=吉安市
吉林=吉林市
吕梁=吕梁市
吴忠=吴忠市
周口=周口市
呼伦贝尔=呼伦贝尔市
呼和浩特=呼和浩特市
咸宁=咸宁市
咸阳=咸阳市
哈尔滨=哈尔滨市
唐山=唐山市
商丘=商丘市
商洛=商洛市
嘉兴=嘉兴市
嘉峪关=嘉峪关市
四平=四平市
固原=固原市
图木舒克=图木舒克市
大同=大同市
大庆=大庆市
大连=大连市
天水=天水市
天津=天津市
天门=天门市
太原=太原市
威海=威海市
娄底=娄底市
孝感=孝感市
宁德=宁德市
宁波=宁波市
安庆=安庆市
安康=安康市
安阳=安阳市
安顺=安顺市
定安=定安县
定西=定西市
宜宾=宜宾市
宜昌=宜昌市
宜春=宜春市
宝鸡=宝鸡市
宣城=宣城市
宿州=宿州市
宿迁=宿迁市
屯昌=屯昌县
岳阳=岳阳市
崇左=崇左市
巢湖=巢湖市
巴中=巴中市
巴彦淖尔=巴彦淖尔市
常州=常州市
常德=常德市
平凉=平凉市
平顶山=平顶山市
广元=广元市
广安=广安市
广州=广州市
庆阳=庆阳市
廊坊=廊坊市
延安=延安市
开封=开封市
张家口=张家口市
张家界=张家界市
张掖=张掖市
徐州=徐州市
德州=德州市
德阳=德阳市
忻州=忻州市
怀化=怀化市
惠州=惠州市
成都=成都市
扬州=扬州市
承德=承德市
抚州=抚州市
抚顺=抚顺市
拉萨=拉萨市
揭阳=揭阳市
攀枝花=攀枝花市
文昌=文昌市
新乡=新乡市
新余=新余市
无锡=无锡市
日照=日照市
昆明=昆明市
昭通=昭通市
晋中=晋中市
晋城=晋城市
普洱=普洱市
景德镇=景德镇市
曲靖=曲靖市
朔州=朔州市
朝阳=朝阳市
本溪=本溪市
来宾=来宾市
杭州=杭州市
松原=松原市
枣庄=枣庄市
柳州=柳州市
株洲=株洲市
桂林=桂林市
梅州=梅州市
梧州=梧州市
榆林=榆林市
武威=武威市
武汉=武汉市
永州=永州市
汉中=汉中市
汕头=汕头市
汕尾=汕尾市
江门=江门市
池州=池州市
沈阳=沈阳市
沧州=沧州市
河池=河池市
河源=河源市
泉州=泉州市
泰安=泰安市
泰州=泰州市
泸州=泸州市
洛阳=洛阳市
济南=济南市
济宁=济宁市
济源=济源市
海口=海口市
淄博=淄博市
淮北=淮北市
淮南=淮南市
淮安=淮安市
深圳=深圳市
清远=清远市
温州=温州市
渭南=渭南市
湖州=湖州市
湘潭=湘潭市
湛江=湛江市
滁州=滁州市
滨州=滨州市
漯河=漯河市
漳州=漳州市
潍坊=潍坊市
潜江=潜江市
潮州=潮州市
澄迈=澄迈县
濮阳=濮阳市
烟台=烟台市
焦作=焦作市
牡丹江=牡丹江市
玉林=玉林市
玉溪=玉溪市
珠海=珠海市
琼海=琼海市
白城=白城市
白山=白山市
白银=白银市
百色=百色市
益阳=益阳市
盐城=盐城市
盘锦=盘锦市
眉山=眉山市
石嘴山=石嘴山市
石家庄=石家庄市
石河子=石河子市
福州=福州市
秦皇岛=秦皇岛市
绍兴=绍兴市
绥化=绥化市
绵阳=绵阳市
聊城=聊城市
肇庆=肇庆市
自贡=自贡市
舟山=舟山市
芜湖=芜湖市
苏州=苏州市
茂名=茂名市
荆州=荆州市
荆门=荆门市
莆田=莆田市
莱芜=莱芜市
菏泽=菏泽市
萍乡=萍乡市
营口=营口市
葫芦岛=葫芦岛市
蚌埠=蚌埠市
衡水=衡水市
衡阳=衡阳市
衢州=衢州市
襄阳=襄阳市
西宁=西宁市
西安=西安市
许昌=许昌市
贵港=贵港市
贵阳=贵阳市
贺州=贺州市
资阳=资阳市
赣州=赣州市
赤峰=赤峰市
辽源=辽源市
辽阳=辽阳市
达州=达州市
运城=运城市
连云港=连云港市
通化=通化市
通辽=通辽市
遂宁=遂宁市
遵义=遵义市
邢台=邢台市
邯郸=邯郸市
邵阳=邵阳市
郑州=郑州市
郴州=郴州市
鄂尔多斯=鄂尔多斯市
鄂州=鄂州市
酒泉=酒泉市
重庆=重庆市
金华=金华市
金昌=金昌市
钦州=钦州市
铁岭=铁岭市
铜川=铜川市
铜陵=铜陵市
银川=银川市
锦州=锦州市
镇江=镇江市
长春=长春市
长沙=长沙市
长治=长治市
阜新=阜新市
阜阳=阜阳市
防城港=防城港市
阳江=阳江市
阳泉=阳泉市
阿拉尔=阿拉尔市
陇南=陇南市
随州=随州市
雅安=雅安市
青岛=青岛市
鞍山=鞍山市
韶关=韶关市
马鞍山=马鞍山市
驻马店=驻马店市
鸡西=鸡西市
鹤壁=鹤壁市
鹤岗=鹤岗市
鹰潭=鹰潭市
黄冈=黄冈市
黄山=黄山市
黄石=黄石市
黑河=黑河市
齐齐哈尔=齐齐哈尔市
龙岩=龙岩市
吐鲁番=吐鲁番地区
吐鲁番市=吐鲁番地区
和田=和田地区
和田市=和田地区
哈密=哈密地区
哈密市=哈密地区
喀什=喀什地区
喀什市=喀什地区
塔城=塔城地区
塔城市=塔城地区
大兴安岭=大兴安岭地区
大兴安岭市=大兴安岭地区
山南=山南地区
山南市=山南地区
日喀则=日喀则地区
日喀则市=日喀则地区
昌都=昌都地区
昌都市=昌都地区
林芝=林芝地区
林芝市=林芝地区
毕节=毕节地区
毕节市=毕节地区
海东=海东地区
海东市=海东地区
那曲=那曲地区
那曲市=那曲地区
铜仁=铜仁地区
铜仁市=铜仁地区
阿克苏=阿克苏地区
阿克苏市=阿克苏地区
阿勒泰=阿勒泰地区
阿勒泰市=阿勒泰地区
阿里=阿里地区
阿里市=阿里地区
乐东=乐东黎族自治县
乐东县=乐东黎族自治县
保亭=保亭黎族苗族自治县
保亭县=保亭黎族苗族自治县
昌江=昌江黎族自治县
昌江县=昌江黎族自治县
琼中=琼中黎族苗族自治县
琼中县=琼中黎族苗族自治县
白沙=白沙黎族自治县
白沙县=白沙黎族自治县
陵水=陵水黎族自治县
陵水县=陵水黎族自治县
阿坝=阿坝藏族羌族自治州
阿坝市=阿坝藏族羌族自治州
阿坝州=阿坝藏族羌族自治州
巴音郭楞=巴音郭楞蒙古自治州
巴音郭楞市=巴音郭楞蒙古自治州
巴音郭楞州=巴音郭楞蒙古自治州
博尔塔拉=博尔塔拉蒙古自治州
博尔塔拉市=博尔塔拉蒙古自治州
博尔塔拉州=博尔塔拉蒙古自治州
昌吉=昌吉回族自治州
昌吉市=昌吉回族自治州
昌吉州=昌吉回族自治州
楚雄=州楚雄彝族自治州
楚雄市=州楚雄彝族自治州
楚雄州=州楚雄彝族自治州
大理=大理白族自治州
大理市=大理白族自治州
大理州=大理白族自治州
德宏=德宏傣族景颇族自治州
德宏市=德宏傣族景颇族自治州
德宏州=德宏傣族景颇族自治州
迪庆=迪庆藏族自治州
迪庆市=迪庆藏族自治州
迪庆州=迪庆藏族自治州
恩施=恩施土家族苗族自治州
恩施市=恩施土家族苗族自治州
恩施州=恩施土家族苗族自治州
甘南=甘南藏族自治州
甘南市=甘南藏族自治州
甘南州=甘南藏族自治州
甘孜=甘孜藏族自治州
甘孜市=甘孜藏族自治州
甘孜州=甘孜藏族自治州
果洛=果洛藏族自治州
果洛市=果洛藏族自治州
果洛州=果洛藏族自治州
海北=海北藏族自治州
海北市=海北藏族自治州
海北州=海北藏族自治州
海南=海南藏族自治州
海南市=海南藏族自治州
海南州=海南藏族自治州
海西=海西蒙古族藏族自治州
海西市=海西蒙古族藏族自治州
海西州=海西蒙古族藏族自治州
红河=红河哈尼族彝族自治州
红河市=红河哈尼族彝族自治州
红河州=红河哈尼族彝族自治州
黄南=黄南藏族自治州
黄南市=黄南藏族自治州
黄南州=黄南藏族自治州
克孜勒=克孜勒苏柯尔克孜自治州
克孜勒市=克孜勒苏柯尔克孜自治州
克孜勒苏柯尔克孜=克孜勒苏柯尔克孜自治州
克孜勒苏柯尔克孜市=克孜勒苏柯尔克孜自治州
克孜勒苏柯尔克孜州=克孜勒苏柯尔克孜自治州
克孜勒州=克孜勒苏柯尔克孜自治州
凉山=凉山彝族自治州
凉山市=凉山彝族自治州
凉山州=凉山彝族自治州
临夏=临夏回族自治州
临夏市=临夏回族自治州
临夏州=临夏回族自治州
怒江=怒江傈僳族自治州
怒江市=怒江傈僳族自治州
怒江州=怒江傈僳族自治州
黔东南=黔东南苗族侗族自治州
黔东南市=黔东南苗族侗族自治州
黔东南州=黔东南苗族侗族自治州
黔南=黔南布依族苗族自治州
黔南市=黔南布依族苗族自治州
黔南州=黔南布依族苗族自治州
黔西南=黔西南布依族苗族自治州
黔西南市=黔西南布依族苗族自治州
黔西南州=黔西南布依族苗族自治州
文山=文山壮族苗族自治州
文山市=文山壮族苗族自治州
文山州=文山壮族苗族自治州
西双版纳=西双版纳傣族自治州
西双版纳市=西双版纳傣族自治州
西双版纳州=西双版纳傣族自治州
湘西=湘西土家族苗族自治州
湘西市=湘西土家族苗族自治州
湘西州=湘西土家族苗族自治州
延边=延边朝鲜族自治州
延边市=延边朝鲜族自治州
延边州=延边朝鲜族自治州
伊犁=伊犁哈萨克自治州
伊犁市=伊犁哈萨克自治州
伊犁州=伊犁哈萨克自治州
玉树=玉树藏族自治州
玉树市=玉树藏族自治州
玉树州=玉树藏族自治州